s,s,s,s,s,s,s,s,s,s,s,s,s,s,s,s,s,s,s
s,-,x,-,-,-,-,-,-,-,-,-,-,-,-,-,-,-,s
s,-,x,-,-,-,-,-,-,-,-,-,-,-,-,x,-,-,s
s,-,x,x,x,x,x,x,x,x,x,x,x,x,-,x,-,-,s
s,-,x,x,x,x,x,x,x,x,x,x,x,x,-,x,-,-,s
s,-,-,-,-,-,-,-,-,-,-,-,-,-,-,x,-,-,s
s,-,x,x,x,x,x,x,x,x,x,x,x,x,-,x,-,-,s
s,-,x,-,-,-,-,-,-,-,-,-,-,-,-,-,-,-,s
s,-,x,-,x,x,x,x,x,x,x,x,x,x,x,x,x,x,s
s,-,x,-,-,-,-,-,-,-,-,-,-,-,-,-,-,-,s
s,-,x,-,x,x,x,x,x,x,x,x,x,x,x,x,x,-,s
s,-,-,-,-,-,-,-,-,-,-,-,-,-,-,-,-,-,s
s,s,s,s,s,s,s,s,s,-,-,s,s,s,s,s,s,s,s
