s,s,s,s,s,s,s,s,s,s,s,s,s,s,s,s,s,s,s
s,d,x,-,-,-,-,-,-,-,-,-,-,-,a,-,-,-,s
s,x,x,-,-,-,-,-,-,-,-,-,-,-,-,x,-,-,s
s,b,x,x,x,x,x,x,x,x,x,x,x,x,-,x,-,-,s
s,-,x,x,x,x,x,x,x,x,x,x,x,x,-,x,-,-,s
s,-,-,-,-,-,-,-,-,-,-,-,-,-,-,x,-,-,s
s,-,x,x,x,x,x,x,x,x,x,x,x,x,-,x,-,-,s
s,-,x,u,-,-,-,-,-,-,-,-,-,-,-,-,-,-,s
s,-,x,-,x,x,x,x,x,x,x,x,x,x,x,x,x,x,s
s,-,x,-,-,-,-,-,-,-,-,-,-,-,-,-,-,c,s
s,-,x,-,x,x,x,x,x,x,x,x,x,x,x,x,x,-,s
s,-,-,-,-,-,-,-,-,-,-,-,-,-,-,-,-,-,s
s,s,s,s,s,s,s,s,s,-,-,s,s,s,s,s,s,s,s
